====================
=........==...g....=
=......=.==.=......=
 *=  =.=.==.=.=  =*
=.====.=.==.=.====.=
=..............G...=
====================