====================
=........==...g....=
=.====.=.==.=.====.=
 *=  =.=.==.=.=  =*
=.====.=.==.=.====.=
=..............G...=
 .....G..====......
=..................=
=..................=
=======..........===
====================