====================
=........==...g....=
=.====.=.==.=.====.=
 *=  =.=.==.=.=  =*
=.====.=.==.=.====.=
=..............G...=
 .....G..====......
 ..................
 ..................
=======..........===
====================